
         .---------------------------------------.---------.    
         | A                                     |         |    
         |    .-----------------------------.    |    .    |    
         |    |                             |    |    |    |    
         |    |    .-------------------.    |    |    |    |    
         |    |    |                   |    |    |    |    |    
         |    |    .----     .----     |    |    |    |    |    
         |    |              |         |    |    |    |    |    
         |    |    .---------.---------:    |    .----'    |   
         |    |    |                   |    |              |    
         |    .----.    .---------.    |    .---------.    |    
         |         |    |         |    |              |    |    
         |    .    |    |    .    |    |     ---------'    |    
         |    |    |    |    |    |    |                   |    
         :----.    |    |    |    |    |    .--------------:    
         |         |    |  B |    |    |    |              |    
         |    .    |    .----'    |    |    |     ----.    |    
         |    |    |              |    |    |         |    |    
         |    .----.----------    |    |    .---------'    |    
         |                        |    |                   |    
         .------------------------'    .-------------------' 